
Logarithmic_Fast - Final Layout
┌────┬────┬────┬────┬────┬────┬────┬────┬────┬────┐
│ x  │ v  │ w  │ c  │ h  │ i  │ t  │ k  │ z  │ '  │
├────┼────┼────┼────┼────┼────┼────┼────┼────┼────┤
│ f  │ m  │ r  │ s  │ n  │ e  │ a  │ o  │ ,  │ .  │
├────┼────┼────┼────┼────┼────┼────┼────┼────┼────┤
│ q  │ b  │ p  │ l  │ d  │ g  │ u  │ y  │ ;  │ j  │
└────┴────┴────┴────┴────┴────┴────┴────┴────┴────┘

Layout as list:
['x', 'v', 'w', 'c', 'h', 'i', 't', 'k', 'z', "'", 'f', 'm', 'r', 's', 'n', 'e', 'a', 'o', ',', '.', 'q', 'b', 'p', 'l', 'd', 'g', 'u', 'y', ';', 'j']
